R  1024 720

NO ./images/wallgreen256x256.xpm
SO ./images/wallblue256x256.xpm
WE ./images/wallyellow256x256.xpm
EA ./images/wallred256x256.xpm

S ./images/barrel.xpm

C 50,120,200

F 145,145,145

       11111111111111111111
       10000000000110000011
       11011000001110000011111111
        1001002000000000E00200001
111111111011000001110000000000001
10000000001100000111011111111111
11110111111111011100000010001
11110111111111011101010010001
11000000110101011100000000001
100020000200000011000000100011
102002020020000011010100100001
1100000111010101 1110111100011
11111111 1110101 101111010001
1111 111 1111111 111111010111
                       111111
                           11111111
                           10000001
                           10000001
                           10000001
                           10000001
                           11111111