R 10241 7201

NO ./images/wallgreen256x256.xpm
SO ./images/wallblue256x256.xpm
WE ./images/wallyellow256x256.xpm
EA ./images/wallpurple256x256.xpm

S ./images/barrel.xpm

C 255,22,100

F 65,222,65


111111111111111111111
1000000000000000000001
1000000000000000000001
1000100000000000000001
1000000000000000000001
1010E01000000000000001
1000000000000000000001
1000100000000000000001
1000000000000000000011
100000000000000000001
100000000000000001111
1000000000000000011021
100000000000000001111
111111111111111111111
1000100000000000000001
111110000000000000001
111111111111111111111
