R 1024 720

NO ./images/wallgreen256x256.xpm
SO ./images/wallblue256x256.xpm
WE ./images/wallyellow256x256.xpm
TO ./images/wallred256x256.xpm
EA ./images/wallpurple256x256.xpm

S ./images/barrel.xpm

C 255,0,0

F 65,200,65

       1111111111111111111
       1000000000011000011
       1101100000111000011111111
        100100200000000E00200001
111111111011000001110000000000001
10000000001100000111011111111111
11110111111111011100000010001
1111011111111101101010010001
11000000110101011100000000001
10000000000000011000000100011
100000000000000011010100100001
1100000111010101 1110111100011
11111111 1110101 101111010001
1111 111 1111111 111111010111
                       1111111
                           11111111
                           10000001
                           10000001
                           10000001
                           10000001
                           11111111