R  1024 720

NO ./images/wallgreen256x256.xpm
SO ./images/wallblue256x256.xpm
WE ./images/wallyellow256x256.xpm
EA ./images/wallred256x256.xpm

S ./images/barrel.xpm

C 50,120,200

F 100,145,145


111111111111111111111
100000000200000000001
100000000000000000001
100200000E00000000001
100000202000000020001
100000000000000000001
100000200000000000001
111111111111111111111
 
111111111111111111111
100000000000000000001
111111111111000000001
111111111111111111111